   
    {9, 9, 9, 9, 2, 9, 9, 9, 9, 9, 9, 9, 9, 9, 9, 9, 9, 9, 9, 9},
    {9, 9, 9, 9, 0, 0, 0, 0, 0, 0, 0, 0, 0, 9, 0, 0, 0, 0, 9, 0},
    {0, 9, 0, 9, 9, 9, 0, 9, 9, 9, 9, 9, 0, 9, 0, 9, 9, 9, 0, 9},
    {0, 9, 0, 0, 0, 9, 0, 0, 0, 0, 9, 0, 0, 9, 0, 0, 9, 0, 0, 9},
    {0, 9, 9, 9, 0, 9, 0, 9, 9, 9, 9, 9, 0, 9, 0, 0, 9, 9, 9, 9},
    {0, 0, 0, 9, 0, 0, 0, 0, 9, 0, 0, 0, 0, 9, 9, 9, 0, 9, 0, 0},
    {9, 0, 9, 9, 9, 9, 9, 9, 9, 9, 9, 9, 0, 9, 0, 0, 0, 9, 9, 9},
    {0, 0, 0, 9, 0, 0, 0, 0, 0, 0, 9, 0, 0, 0, 0, 0, 9, 0, 0, 9},
    {9, 9, 9, 9, 0, 9, 9, 9, 9, 9, 9, 9, 9, 9, 9, 0, 9, 9, 9, 9},
    {0, 0, 0, 9, 0, 0, 0, 0, 0, 0, 0, 0, 0, 0, 0, 0, 0, 0, 0, 9},
    {9, 9, 9, 9, 9, 0, 9, 9, 9, 9, 9, 9, 9, 0, 9, 9, 9, 9, 9, 9},
    {0, 0, 0, 9, 0, 0, 0, 0, 0, 0, 0, 0, 0, 0, 0, 0, 0, 0, 0, 9},
    {9, 9, 9, 9, 0, 9, 0, 9, 9, 9, 9, 9, 0, 9, 0, 0, 0, 9, 0, 9},
    {0, 0, 0, 0, 0, 9, 0, 0, 0, 0, 9, 0, 0, 9, 0, 9, 9, 9, 0, 9},
    {9, 9, 9, 9, 9, 9, 9, 9, 9, 9, 9, 9, 0, 9, 0, 0, 9, 9, 9, 9},
    {0, 0, 0, 9, 0, 0, 0, 0, 0, 0, 9, 0, 0, 0, 0, 0, 9, 0, 0, 9},
    {0, 9, 0, 9, 0, 9, 9, 9, 0, 9, 9, 9, 0, 9, 0, 0, 9, 9, 9, 9},
    {0, 9, 0, 9, 0, 0, 0, 0, 0, 0, 0, 0, 0, 0, 0, 9, 0, 9, 0, 0},
    {0, 9, 9, 9, 9, 9, 9, 9, 9, 0, 9, 9, 9, 9, 0, 9, 0, 9, 9, 9},
    {9, 9, 9, 9, 9, 9, 9, 9, 9, 1, 9, 9, 9, 9, 9, 9, 9, 9, 9, 0}
